[5,10]
(4,2)
(8,3)
(2,0,1,1)
(6,1,1,1)
(9,1,1,1)
(2,3,1,1)
(4,4,1,1)