[5,10]
(0,0)
(4,2)
(3,1,1,1)
(4,1,1,1)
(5,1,1,1)
(3,2,1,1)
(5,2,1,1)
(3,3,1,1)
(4,3,1,1)
(5,3,1,1) 